125,21
#############                                                                                                               
#@**********#                                                                                                               
#*******1***#                                                                                                               
#***********#                                                                                                               
#####*#######                                                                                                               
    #*#                                                                                                                     
    #*#                                                                                                                     
    #*#                                                                                                                     
    #*#                ################                                                                                     
#####*############     #**************#                                                                                     
#****************#######**************#                                                                                     
#*************************************#                                                                                     
#****************#######**************#                                                                                     
#***K*k**********#     #**************#                                                                                     
##################     ################                                                                                     
                                                                                                                            
                                                                                                                            
                                                                                                                            
                                                                                                                            
                                                                                                                            
                                                                                                                            